Level	Life	Ability	Attack	Defense	Hit	Dodge	Crit	Resist	Cost
神仙法系，1：生命 2：攻击 3：命中 4：暴击 5：抗暴 6：防御 7：闪避	生命缩放比例（1000为100%）	内力缩放比例（1000为100%）	攻击缩放比例（1000为100%）	防御缩放比例（1000为100%）	命中缩放比例（1000为100%）	闪避缩放比例（1000为100%）	暴击缩放比例（1000为100%）	抗暴缩放比例（1000为100%）	Cost
1	240	1000	1000	1000	1000	1000	1000	1000	
2	180	1000	1200	1000	1000	1000	1000	1000	
3	180	1000	1000	1000	1200	1000	1000	1000	
4	180	1000	1000	1000	1000	1000	1200	1000	
5	180	1000	1000	1000	1000	1000	1000	1200	
6	180	1000	1000	1200	1000	1000	1000	1000	
7	180	1000	1000	1000	1000	1200	1000	1000	
